********************
*     *     *      *
* *** * *** * **** *
* *   *   * * *    *
* * ***** * * * ** *
*       *   * * *  *
***** * ***** * * **
*   * *     * * *  *
* * * ***** * * ** *
* *     *   * *    *
* ***** * *** **** *
* *     * * *      *
* * ***** * * ******
* *       *        *
* *** ********** * *
*   *            * *
*** ************** *
*                  *
********************