*****
*   *
*   *
**  *
*****
