**********
*        *
*        *
*        *
*   **   *
*   **   *
*        *
*        *
*        *
**********
