***************
*   *     *   *
* * * *** * * *
* *     * * * *
* ***** * * * *
*     * * *   *
*** * * * *** *
*   * * *     *
* *** * ***** *
*   *     *   *
* ***** * * * *
*     * * * * *
* ***** * * * *
*       *     *
***************