*******************
*    *     *       *
* ** * ***** * *** *
*    *     * *   * *
* ** ***** * *** * *
*    *   * *     * *
* ** * * * ******* *
*    * * *         *
****** * ***********
*      *           *
* **** * ********* *
* *    *         * *
* * ** ********* * *
* *              * *
* * **************  
* *                *
* **************** *
*                * *
****************** *
********************