*****
*   *
**  *
* * *
*****
