********************
**                 *
* *  *             *
*  *  *  *   *     *
* *    *  *   *    *
**         *   *   *
*       *       *  *
*      *       *   *
*     *      *     *
*    *      * *    *
*   *      *   *   *
*  *      *     *  *
* *               **
**                 *
* * * * * * * * * **
*     **     * *   *
*    *  *   *   *  *
*   *    * *     * *
*  *               *
********************
