********************
*                  *
*     *  ********  *
*    **        *   *
*   * *       *    *
*  *  *      *     *
* *   *  *******   *
**    *    *       *
*     *   *        *
*     *  *         *
*     * *  **  **  *
*     *   *  **  * *
*     *   *      * *
*     *    *     * *
*     *     *   *  *
*     *      * *   *
*  *******    *    *
*                  *
*                  *
********************
