********************
* *   *   *   *   **
*       *   *   *  *
*  ** *   *   *   **
*       *   *   *  *
* *   *   *   *   **
*       *   *   *  *
*       *   *   *  *
* * * *   *   *   **
*       *   *   *  *
*       *   *   *  *
* * * *   *   *   **
*       *   *   *  *
*       *   *   *  *
* * * *   *   *   **
*       *   *      *
*   *   *   *   *  *
* *   *   *   * * **
*                  *
********************
