********************
*                  *
*                  *
*  ** ***********  *
*  *            *  *
*  *            *  *
*  *   *****       *
*  *   *   *    *  *
*  *   *   *    *  *
*  *   *   *    *  *
*  *   *****    *  *
*               *  *
*  *            *  *
*  *            *  *
*  *            *  *
*  ******* ******  *
*                  *
*                  *
*                  *
********************
