********************
*                  *
*                  *
*   *    *   *     *
*                  *
*                  *
* *              * *
*       *     *    *
*     *            *
*                  *
*                  *
*   *    *         *
*            *     *
*                  *
*                  *
*     *            *
*        *      *  *
* *                *
*                  *
********************
