********************
*                  *
*                  *
*                  *
*   *         *    *
*    *       *     *
*     *     *      *
*      *   *       *
*       * *        *
*        *         *
*       * *        *
*      *   *       *
*     *     *      *
*    *       *     *
*   *         *    *
*                  *
*                  *
*                  *
*                  *
********************
