*****
** **
*   *
** **
*   *
** **
*****
