**********
*        *
* ****** *
* *    * *
* * ** * *
* * ** * *
* *    * *
* ****** *
*        *
**********