********************
*                  *
* * *** ** * * * * *
* * * *  * * * * * *
* * * ** * * *** * *
* * *  * * *  *  * *
* * ** *** *  **** *
* *  *     * **    *
* *  * * * * *  ** *
*    * * * * * *** *
* * ** * ********* *
* *  * *        *  *
* **** *********** *
* * ** *********** *
* *     *       ** *
* ****  *** * * ** *
*    *  * * * * ** *
* ****  * * *** ** *
*                  *
********************
