*****
*  **
* * *
*  **
*****
