{ 
    "name": "Level 1",
    "width": 10,
    "height": 10,
    "tiles": [
      [1, 1, 1, 1, 1, 1, 1, 1, 1, 1],
      [1, 5, 0, 0, 0, 0, 0, 0, 6, 1],
      [1, 0, 1, 2, 0, 1, 0, 2, 0, 1],
      [1, 0, 0, 0, 7, 0, 4, 0, 0, 1],
      [1, 1, 1, 1, 1, 1, 1, 1, 1, 1]
    ]
  }

