*******
***  **
**   **
***   *
*     *
*******
