******
*** **
* * **
******
******
******
