******
*    *
*  * *
** * *
** * *
******
